10 33
|||||||||||||||||||||||||||||||||
|0         ||      ||       || ||
|||| || || || ||||||| ||||| || ||
|||| || || ||            || || ||
|    || ||    |||||||||| || ||X||
||||||| || ||            || || ||
||||||| || ||||||| || || || || ||
|               || || || ||    ||
|||||||||||||||||||||||||||||||||
